Language	Family
Afrikaans_2.6	West_Germanic	Germanic	Indo_European
Amharic_2.6	West_Semitic	Semitic
Archaic_Greek	Greek	Indo_European
Classical_Greek	Archaic_Greek	Greek	Indo_European
Koine_Greek	Classical_Greek	Archaic_Greek	Greek	Indo_European
Arabic_2.6	Arabic	North_West_Semitic	Semitic
Armenian_2.6	Armenian	Indo_European
Bambara_2.6	Mande	Niger_Congo
Basque_2.6	Basque
Breton_2.6	Insular_Celtic	Indo_European
Bulgarian_2.6	Old_Church_Slavonic_2.6	South_Slavic	Slavic	Indo_European
Buryat_2.6	Mongolic
Cantonese_2.6	Classical_Chinese_2.6	Sino-Tibetan
Catalan_2.6	Latin_2.6	Indo_European
Chinese_2.6	Classical_Chinese_2.6	Sino-Tibetan
Classical_Chinese_2.6	Sino-Tibetan
Coptic_2.6	Egyptian	Afroasiatic
Croatian_2.6	Serbo_Croatian	South_Slavic	Slavic	Indo_European
Czech_2.6	West_Slavic	Slavic	Indo_European
Danish_2.6	North_Germanic	Germanic	Indo_European
Dutch_2.6	West_Germanic	Germanic	Indo_European
English_2.6	West_Germanic	Germanic	Indo_European
Erzya_2.6	Mordvin	Uralic
Estonian_2.6	Finnic	Uralic
Faroese_2.6	North_Germanic	Germanic	Indo_European
Finnish_2.6	Finnic	Uralic
French_2.6	Latin_2.6	Indo_European
German_2.6	West_Germanic	Germanic	Indo_European
Gothic_2.6	Germanic	Indo_European
Greek_2.6	Koine_Greek	Classical_Greek	Archaic_Greek	Greek	Indo_European
Hebrew_2.6	North_West_Semitic	Semitic
Hindi_2.6	Hindustani	Sanskrit_2.6	Indo_Iranian	Indo_European
Hungarian_2.6	Ugric	Uralic
Icelandic_2.6	North_Germanic	Germanic	Indo_European
Indonesian_2.6	Malayo-Sumbawan
Irish_2.6	Insular_Celtic	Indo_European
Italian_2.6	Latin_2.6	Indo_European
Japanese_2.6	Japanese
Kazakh_2.6	Turkic
Korean_2.6	Korean
Kurmanji_2.6	Iranian	Indo_Iranian	Indo_European
Latin_2.6	Indo_European
Latvian_2.6	Baltic	Indo_European
Lithuanian_2.6	Baltic	Indo_European
Maltese_2.6	Arabic	North_West_Semitic	Semitic	Afroasiatic
Mbya_Guarani_2.6	Tupian
Naija_2.6	Creole_Naija
North_Sami_2.6	Sami	Uralic
Norwegian_2.6	North_Germanic	Germanic	Indo_European
Old_Church_Slavonic_2.6	South_Slavic	Slavic	Indo_European
Old_French_2.6	Latin_2.6	Indo_European
Old_Russian_2.6	Slavic	Indo_European
Persian_2.6	Iranian	Indo_Iranian	Indo_European
Polish_2.6	West_Slavic	Slavic	Indo_European
Portuguese_2.6	Latin_2.6	Indo_European
Romanian_2.6	Latin_2.6	Indo_European
Russian_2.6	Old_Russian_2.6	Slavic	Indo_European
Sanskrit_2.6	Indo_Iranian	Indo_European
Scottish_Gaelic_2.6	Insular_Celtic
Serbian_2.6	Serbo_Croatian	South_Slavic	Slavic	Indo_European
Sindhi_2.6	Sanskrit_2.6	Indo_Iranian	Indo_European
Slovak_2.6	West_Slavic	Slavic	Indo_European
Slovenian_2.6	South_Slavic	Slavic	Indo_European
Spanish_2.6	Latin_2.6	Indo_European
Swedish_2.6	North_Germanic	Germanic	Indo_European
Thai_2.6	Tai-Kadai
Turkish_2.6	Turkic
Ukrainian_2.6	Slavic	Indo_European
Urdu_2.6	Hindustani	Sanskrit_2.6	Indo_Iranian	Indo_European
Uyghur_2.6	Turkic
Vietnamese_2.6	Viet-Muong
Welsh_2.6	Insular_Celtic	Indo_European
Wolof_2.6	Northern_Atlantic	Atlantic_Congo	Niger_Congo
Yoruba_2.6	Defoid	Atlantic_Congo	Niger_Congo
